17,17,17,9,9,9,9,9,9,9,9,9,9,9,9
17,17,17,9,9,9,9,9,9,9,9,9,9,9,9
17,17,17,9,9,9,9,9,9,9,9,9,9,9,9
17,17,17,9,9,9,9,9,9,9,9,9,9,9,9
17,17,17,9,9,9,9,9,9,9,9,9,9,9,9
27,27,27,9,9,9,9,9,9,9,9,9,9,9,9
9,9,9,9,9,9,9,9,9,9,9,9,9,9,9
9,9,9,9,9,9,9,9,9,9,9,9,9,9,9
9,9,9,9,9,9,9,9,9,9,9,9,9,9,9
9,9,9,9,9,9,9,9,9,9,9,9,9,9,9
9,9,9,9,9,9,9,27,27,27,9,9,9,9,9
9,9,9,9,9,9,9,9,9,9,9,9,9,9,9
9,9,9,9,9,9,9,9,9,9,17,17,17,17,17
9,9,9,9,9,9,9,9,9,9,17,17,17,17,17
9,9,9,9,9,9,9,9,9,9,17,17,17,17,17
